{}	全部表示する
{TEXT}	テキスト
{CAMERA}	カメラ
{ITEM}	アイテム
{BG}	背景
{MUSIC}	音楽
{WAKU}	枠
{LOADUNIT}	ユニット配置
{UNITMOVE}	ユニット移動
{UNITREMOVE}	ユニット消去
{UNITPERSOLNAL}	ユニット人事
{UNIT}	ユニットその他
{WEATHER}	天候
{MAPCHANGE}	マップ変化
{MAPEFFECT}	マップ演出
{MAP}	マップその他
{BATTLE}	イベント戦闘
{SUBROUTINE}	サブルーチン
{COND}	条件
{JUMP}	分岐
{FLAG}	フラグ
{WMAPMOVE}	ワールドマップ移動
{WMAPTEXT}	ワールドマップテキスト
{WMAPUNIT}	ワールドマップユニット
{WMAP}	ワールドマップその他
{ENDING}	エンディング関係
