template_event_COND_UNITALIVE_FE8.txt	もし、ユニットが生きていたら
template_event_COND_UNITALIVE_OR_ELSE_FE8.txt	もし、ユニットが生きているか、または死んでいるか
template_event_COND_YES_OR_NO.txt	会話の選択子Yes/No分岐
template_event_COND_TURN_ODD_FE8.txt	もし、奇数ターンであれば
template_event_COND_TURN_EVEN_FE8.txt	もし、偶数ターンであれば
template_event_COND_TURN_3SCALE_FE8.txt	もし、ターン数が3の倍数であれば
template_event_COND_TURN_LESS_10.txt	もし、10ターン以内であれば
template_event_COND_GOLD_MORE_5000.txt	もし、5000ゴールド以上を所持していたら
template_event_COND_GOLD_MORE_5000_ELSE.txt	もし、5000ゴールド以上を所持しているか、または以外であれば
template_event_COND_UNITALIVE_AND_STIL.txt	もし、敵ユニットを仲間にしておらず生存していたら
template_event_COND_FLAG_ON_FE8.txt	もし、フラグがONであれば
template_event_COND_FLAG_OFF_FE8.txt	もし、フラグがOFFであれば
template_event_COND_FLAG_ON_ELSE_FE8.txt	もし、フラグがONであれば、または以外であれば
template_event_COND_HARDMODE_FE8.txt	もし、ハードモードならば
template_event_COND_HARDMODE_OR_ELSE_FE8.txt	もし、ハードモードならば、またはそれ以外ならば
template_event_COND_TUTORIALMODE_FE8.txt	もし、難易度簡単ならば
template_event_COND_ENEMIES_less3.txt	もし、敵が3体以下だったら
template_event_COND_ENEMIES_more10.txt	もし、敵が10体以上だったら
template_event_COND_RANDOM50_100.txt	もし、乱数で50/100以上の数字を引いたなら
template_event_COND_DEPLOY_FE8.txt	もし、ユニットがマップに配置されていれば
template_event_COND_UNITINAREA_FE8.txt	もし、ユニットが所定の範囲にいるならば
template_event_COND_ACTIVEID_FE8.txt	もし、特定のユニットを操作していれば
template_event_COND_Gaiden.txt	外伝分岐サンプル: もし、5ターン以内クリアであれば外伝へ
template_event_COND_COUNTER_MORE_5_FE8.txt	もし、COUNTERが5以上だったら
template_event_COND_COUNTER_LESS_1_FE8.txt	もし、COUNTERが1以下だったら
template_event_COND_COUNTER_MORE_5_ELSE_FE8.txt	もし、COUNTERが5以上だったら、または以外であれば
template_event_COND_COUNTER_LESS_1_ELSE_FE8.txt	もし、COUNTERが1以下だったら、または以外であれば
template_event_MOVEPOS_AND_FRAME_FE8.txt	カメラを座標に移動させ、座標に枠を点灯させて会話を表示
template_event_MOVEUNIT_AND_FRAME_FE8.txt	ユニットに枠を点灯させて会話を表示
template_event_TalkEventItem_FE8.txt	会話してアイテム入手
template_event_TALK_COND_CHANGE_MUSIC.txt	会話中に、イベントを並列して実行して、音楽を変える
template_event_TalkEventAndFADI_FE8.txt	会話の最後にテキストボックスを表示したままフェードインして真っ黒にする
template_event_BATTLE_Attack_Counter.txt	戦闘イベント 攻撃->反撃
template_event_BATTLE_Attack_Counter_Attack.txt	戦闘イベント 攻撃->反撃->攻撃
template_event_BATTLE_Attack_Counter_Attack_Counter.txt	戦闘イベント 攻撃->反撃->攻撃->反撃
template_event_BATTLE_FromEnemy_Attack_Counter.txt	戦闘イベント 敵から攻撃->反撃
template_event_BATTLE_FromEnemy_Attack_Counter_Attack.txt	戦闘イベント 敵から攻撃->反撃->攻撃
template_event_BATTLE_Attack.txt	戦闘イベント 攻撃->反撃なし
template_event_BATTLE_CRITICAL_KILL_ENEMY.txt	戦闘イベント 攻撃->攻撃->反撃なし (2回攻撃)
template_event_BATTLE_FromEnemy_Attack.txt	戦闘イベント 敵から攻撃->反撃なし
template_event_WarpIN_FE8.txt	ユニットをワープで登場させる
template_event_COND_Coord_WarpOUT_WarpIN_FE8.txt	特定の座標のユニットをワープで移動させる
template_event_RedFadeout.txt	背景を赤色にフェードアウト
template_event_GAMEOVER_FE8.txt	ゲームオーバーを呼び出す
template_event_CALL_END_EVENT_FE8.txt	章をクリアする
template_event_PREPARATION_FE8.txt	自軍と敵軍を読み込み進撃開始を呼び出す
template_event_Turn_off_background_FE8.txt	背景をオフにして消すときにフェードアウトを入れて画面を乱さない
template_event_RedFlushWarningEffect.txt	赤色の警報/警告 画面全体を赤色に点滅させる 画面演出
template_event_StairsSoundEffect.txt	階段を下りるような音を出す 画面演出
template_event_Move_unit_without_closing_balloon_while_talking.txt	会話しながら吹き出しを閉じずにユニットを移動させる
